id,reward_get,jukebox,nebbia,arcade,vegetable,poster,stock
1,1,0,0,0,0,0,0
2,2,0,0,0,0,0,0
3,3,0,0,0,0,0,0
4,4,0,0,0,0,0,0
5,5,0,0,0,0,0,0
6,6,0,0,0,0,0,0
7,7,0,0,0,0,0,0
8,8,0,0,0,0,0,0
9,0,1,0,0,0,0,0
10,0,0,1,0,0,0,0
11,11,0,0,0,0,0,0
12,12,0,0,0,0,0,0
13,0,0,0,1,0,0,0
14,0,0,0,0,0,0,0
15,0,0,0,0,0,0,0
16,0,0,0,0,1,0,0
17,0,0,0,0,0,10056,0
18,0,0,0,0,0,0,0
19,19,0,0,0,0,0,0
20,0,0,0,0,0,10061,0
21,0,0,0,0,0,0,0
22,0,0,0,0,0,0,0
23,0,0,0,0,0,0,23
24,0,0,0,0,0,0,0
